balloon: 6 onile: 3
AddBomb
wwwwwwwwwwwwwwwww
w...............w
w...............ww
w................w
w..........d....ww
w.......w.......w
w.......w.......w
w.......w.......w
w.......d.......w
w..wwwwdddwwww..w
w....p..d.......w
w.......w.......w
w.......w.......w
w.......w.......w
w.......w.......w
w...............w
w...............w
wwwwwwwwwwwwwwwww