balloon: 2
wwwwwwwwwwwwwwwww
w...............w
w.w.w.w.w.w.wdw.ww
w............dd..w
w.w.w.w.wdwdw.w.ww
w.w.w.w.wdwdw.w.w
w..........d....w
w.wdwdwdw.wdw.w.w
w.....dd........w
w.w.w.wdw.w.w.w.w
w...w.w...w.w.w.w
w...............w
w.wdwdwdwdwdwdw.w
w.......d....w..w
w...wwwdddwwww..w
w...w...d.......w
w.......w......pw
wwwwwwwwwwwwwwwww
