balloon: 0
FireUp
wwwwwwwwwwwwwwwww
w...............w
w.w.w.w.w.w.w.w.ww
w................w
w.w.w.w.w.w.w.w.ww
w.w.w.w.w.w.w.w.w
w...............w
w.w.w.w.w.w.w.w.w
w...............w
w.w.w.w.w.w.w.w.w
w...w.w...w.w.w.w
w...............w
w.w.w.w.w.w.wdw.w
w...............w
w..p............w
w...............w
w...............w
wwwwwwwwwwwwwwwww