balloon: 0
WingBoot
wwwwwwwwwwwwwwwww
w...............w
w.w.w.w.w.w.w.w.ww
w................w
w.w.w.w.w.w.w.w.ww
w.w.w.w.w.w.w.w.w
w...............w
w.w.w.w.w.w.w.w.w
w...............w
w.w.w.w.w.w.w.w.w
w...w.w...w.w.w.w
w...............w
w.wdwdwdwdwdwdwdw
w......p.......dw
w.wdwdwdwdwdwdwdw
w...............w
w...............w
wwwwwwwwwwwwwwwww